3,0,0,0,3,0,0,0,5,0,0,3
3,0,0,0,3,0,0,0,0,0,0,3
3,0,0,0,3,0,0,0,0,0,0,3
3,0,0,0,3,0,0,0,0,0,0,3
3,0,0,0,3,0,0,0,0,0,0,3
3,0,0,0,0,0,0,0,0,0,0,3
3,0,0,0,0,0,0,0,0,0,0,3
3,0,0,0,0,0,0,0,0,0,0,3
3,0,0,0,0,0,0,0,0,0,0,3
3,0,0,0,0,0,0,0,0,0,0,3
3,0,0,0,0,0,0,0,0,0,0,3
2,2,2,2,2,2,2,2,2,2,2,3